,Unnamed: 0,Unnamed: 0.1,Unnamed: 0.1.1,date,state,rtk-ag,pcr,total
0,0,0,0,2021-07-01,Johor,2749,3670,6419
1,1,1,1,2021-07-01,Kedah,2073,1297,3370
2,2,2,2,2021-07-01,Kelantan,1348,1966,3314
3,3,3,3,2021-07-01,Melaka,1049,2132,3181
4,4,4,4,2021-07-01,Negeri Sembilan,2151,3306,5457
5,5,5,5,2021-07-01,Pahang,2103,2605,4708
6,6,6,6,2021-07-01,Perak,1235,3715,4950
7,7,7,7,2021-07-01,Perlis,105,16,121
8,8,8,8,2021-07-01,Pulau Pinang,4632,1528,6160
9,9,9,9,2021-07-01,Sabah,3212,3465,6677
10,10,10,10,2021-07-01,Sarawak,2043,5479,7522
11,11,11,11,2021-07-01,Selangor,13805,16460,30265
12,12,12,12,2021-07-01,Terengganu,970,1397,2367
13,13,13,13,2021-07-01,W.P. Kuala Lumpur,3713,7182,10895
14,14,14,14,2021-07-01,W.P. Labuan,1913,268,2181
15,15,15,15,2021-07-01,W.P. Putrajaya,118,325,443
16,16,16,16,2021-07-02,Johor,2455,4428,6883
17,17,17,17,2021-07-02,Kedah,1571,1212,2783
18,18,18,18,2021-07-02,Kelantan,436,2343,2779
19,19,19,19,2021-07-02,Melaka,1249,2691,3940
20,20,20,20,2021-07-02,Negeri Sembilan,2151,5485,7636
21,21,21,21,2021-07-02,Pahang,1945,2861,4806
22,22,22,22,2021-07-02,Perak,1658,2028,3686
23,23,23,23,2021-07-02,Perlis,60,48,108
24,24,24,24,2021-07-02,Pulau Pinang,4286,1368,5654
25,25,25,25,2021-07-02,Sabah,3273,3290,6563
26,26,26,26,2021-07-02,Sarawak,1689,6441,8130
27,27,27,27,2021-07-02,Selangor,14198,15277,29475
28,28,28,28,2021-07-02,Terengganu,506,1307,1813
29,29,29,29,2021-07-02,W.P. Kuala Lumpur,3823,6160,9983
30,30,30,30,2021-07-02,W.P. Labuan,1351,377,1728
31,31,31,31,2021-07-02,W.P. Putrajaya,209,326,535
32,32,32,32,2021-07-03,Johor,1810,3484,5294
33,33,33,33,2021-07-03,Kedah,1550,1386,2936
34,34,34,34,2021-07-03,Kelantan,654,825,1479
35,35,35,35,2021-07-03,Melaka,718,2603,3321
36,36,36,36,2021-07-03,Negeri Sembilan,1538,3352,4890
37,37,37,37,2021-07-03,Pahang,1576,2418,3994
38,38,38,38,2021-07-03,Perak,897,2244,3141
39,39,39,39,2021-07-03,Perlis,59,43,102
40,40,40,40,2021-07-03,Pulau Pinang,4070,1718,5788
41,41,41,41,2021-07-03,Sabah,2519,3623,6142
42,42,42,42,2021-07-03,Sarawak,1132,5259,6391
43,43,43,43,2021-07-03,Selangor,10427,17848,28275
44,44,44,44,2021-07-03,Terengganu,703,643,1346
45,45,45,45,2021-07-03,W.P. Kuala Lumpur,2365,9017,11382
46,46,46,46,2021-07-03,W.P. Labuan,745,234,979
47,47,47,47,2021-07-03,W.P. Putrajaya,54,326,380
48,48,48,48,2021-07-04,Johor,2847,2467,5314
49,49,49,49,2021-07-04,Kedah,2045,1120,3165
50,50,50,50,2021-07-04,Kelantan,1261,1477,2738
51,51,51,51,2021-07-04,Melaka,701,2418,3119
52,52,52,52,2021-07-04,Negeri Sembilan,960,2835,3795
53,53,53,53,2021-07-04,Pahang,830,2127,2957
54,54,54,54,2021-07-04,Perak,940,1207,2147
55,55,55,55,2021-07-04,Perlis,28,14,42
56,56,56,56,2021-07-04,Pulau Pinang,1586,957,2543
57,57,57,57,2021-07-04,Sabah,1842,2881,4723
58,58,58,58,2021-07-04,Sarawak,1414,5487,6901
59,59,59,59,2021-07-04,Selangor,7472,13740,21212
60,60,60,60,2021-07-04,Terengganu,1223,592,1815
61,61,61,61,2021-07-04,W.P. Kuala Lumpur,1718,4945,6663
62,62,62,62,2021-07-04,W.P. Labuan,1137,240,1377
63,63,63,63,2021-07-04,W.P. Putrajaya,60,150,210
64,64,64,64,2021-07-05,Johor,3428,3437,6865
65,65,65,65,2021-07-05,Kedah,2376,1405,3781
66,66,66,66,2021-07-05,Kelantan,1241,2398,3639
67,67,67,67,2021-07-05,Melaka,1018,1324,2342
68,68,68,68,2021-07-05,Negeri Sembilan,2609,2718,5327
69,69,69,69,2021-07-05,Pahang,1971,2277,4248
70,70,70,70,2021-07-05,Perak,1729,1075,2804
71,71,71,71,2021-07-05,Perlis,155,26,181
72,72,72,72,2021-07-05,Pulau Pinang,4099,925,5024
73,73,73,73,2021-07-05,Sabah,2926,2813,5739
74,74,74,74,2021-07-05,Sarawak,2731,4138,6869
75,75,75,75,2021-07-05,Selangor,13111,14189,27300
76,76,76,76,2021-07-05,Terengganu,989,566,1555
77,77,77,77,2021-07-05,W.P. Kuala Lumpur,4870,4207,9077
78,78,78,78,2021-07-05,W.P. Labuan,1447,174,1621
79,79,79,79,2021-07-05,W.P. Putrajaya,241,147,388
80,80,80,80,2021-07-06,Johor,2864,4235,7099
81,81,81,81,2021-07-06,Kedah,1755,1147,2902
82,82,82,82,2021-07-06,Kelantan,1261,2231,3492
83,83,83,83,2021-07-06,Melaka,1105,2462,3567
84,84,84,84,2021-07-06,Negeri Sembilan,2377,3911,6288
85,85,85,85,2021-07-06,Pahang,2106,3299,5405
86,86,86,86,2021-07-06,Perak,1650,2386,4036
87,87,87,87,2021-07-06,Perlis,77,17,94
88,88,88,88,2021-07-06,Pulau Pinang,4274,1480,5754
89,89,89,89,2021-07-06,Sabah,3213,3062,6275
90,90,90,90,2021-07-06,Sarawak,1361,6216,7577
91,91,91,91,2021-07-06,Selangor,12120,13235,25355
92,92,92,92,2021-07-06,Terengganu,875,1206,2081
93,93,93,93,2021-07-06,W.P. Kuala Lumpur,4179,7516,11695
94,94,94,94,2021-07-06,W.P. Labuan,581,233,814
95,95,95,95,2021-07-06,W.P. Putrajaya,250,320,570
96,96,96,96,2021-07-07,Johor,2539,4197,6736
97,97,97,97,2021-07-07,Kedah,2288,2103,4391
98,98,98,98,2021-07-07,Kelantan,1134,1917,3051
99,99,99,99,2021-07-07,Melaka,1218,2416,3634
100,100,100,100,2021-07-07,Negeri Sembilan,2386,4001,6387
101,101,101,101,2021-07-07,Pahang,2137,2833,4970
102,102,102,102,2021-07-07,Perak,2527,1845,4372
103,103,103,103,2021-07-07,Perlis,104,15,119
104,104,104,104,2021-07-07,Pulau Pinang,4111,1459,5570
105,105,105,105,2021-07-07,Sabah,2821,4085,6906
106,106,106,106,2021-07-07,Sarawak,1635,5548,7183
107,107,107,107,2021-07-07,Selangor,12536,18764,31300
108,108,108,108,2021-07-07,Terengganu,1037,923,1960
109,109,109,109,2021-07-07,W.P. Kuala Lumpur,5188,9201,14389
110,110,110,110,2021-07-07,W.P. Labuan,693,164,857
111,111,111,111,2021-07-07,W.P. Putrajaya,180,408,588
112,112,112,112,2021-07-08,Johor,2551,3953,6504
113,113,113,113,2021-07-08,Kedah,2803,2181,4984
114,114,114,114,2021-07-08,Kelantan,1176,2074,3250
115,115,115,115,2021-07-08,Melaka,1485,2465,3950
116,116,116,116,2021-07-08,Negeri Sembilan,2844,4642,7486
117,117,117,117,2021-07-08,Pahang,1478,2397,3875
118,118,118,118,2021-07-08,Perak,1714,1912,3626
119,119,119,119,2021-07-08,Perlis,83,51,134
120,120,120,120,2021-07-08,Pulau Pinang,3510,1786,5296
121,121,121,121,2021-07-08,Sabah,3108,4614,7722
122,122,122,122,2021-07-08,Sarawak,1776,5574,7350
123,123,123,123,2021-07-08,Selangor,16973,18530,35503
124,124,124,124,2021-07-08,Terengganu,972,1002,1974
125,125,125,125,2021-07-08,W.P. Kuala Lumpur,4962,8540,13502
126,126,126,126,2021-07-08,W.P. Labuan,662,176,838
127,127,127,127,2021-07-08,W.P. Putrajaya,251,261,512
128,128,128,128,2021-07-09,Johor,2993,5359,8352
129,129,129,129,2021-07-09,Kedah,1931,1467,3398
130,130,130,130,2021-07-09,Kelantan,473,1642,2115
131,131,131,131,2021-07-09,Melaka,1639,4050,5689
132,132,132,132,2021-07-09,Negeri Sembilan,2046,5721,7767
133,133,133,133,2021-07-09,Pahang,2201,2862,5063
134,134,134,134,2021-07-09,Perak,1741,2350,4091
135,135,135,135,2021-07-09,Perlis,104,28,132
136,136,136,136,2021-07-09,Pulau Pinang,3714,1650,5364
137,137,137,137,2021-07-09,Sabah,3012,3474,6486
138,138,138,138,2021-07-09,Sarawak,1182,5803,6985
139,139,139,139,2021-07-09,Selangor,21468,19914,41382
140,140,140,140,2021-07-09,Terengganu,486,1189,1675
141,141,141,141,2021-07-09,W.P. Kuala Lumpur,5725,7903,13628
142,142,142,142,2021-07-09,W.P. Labuan,1341,314,1655
143,143,143,143,2021-07-09,W.P. Putrajaya,238,351,589
144,144,144,144,2021-07-10,Johor,2177,4402,6579
145,145,145,145,2021-07-10,Kedah,1786,1640,3426
146,146,146,146,2021-07-10,Kelantan,802,1718,2520
147,147,147,147,2021-07-10,Melaka,794,2160,2954
148,148,148,148,2021-07-10,Negeri Sembilan,1606,4284,5890
149,149,149,149,2021-07-10,Pahang,1215,2373,3588
150,150,150,150,2021-07-10,Perak,932,2035,2967
151,151,151,151,2021-07-10,Perlis,35,27,62
152,152,152,152,2021-07-10,Pulau Pinang,3240,1590,4830
153,153,153,153,2021-07-10,Sabah,2488,3284,5772
154,154,154,154,2021-07-10,Sarawak,913,5927,6840
155,155,155,155,2021-07-10,Selangor,23470,17260,40730
156,156,156,156,2021-07-10,Terengganu,1080,1163,2243
157,157,157,157,2021-07-10,W.P. Kuala Lumpur,5223,7635,12858
158,158,158,158,2021-07-10,W.P. Labuan,1065,137,1202
159,159,159,159,2021-07-10,W.P. Putrajaya,43,327,370
160,160,160,160,2021-07-11,Johor,3101,3398,6499
161,161,161,161,2021-07-11,Kedah,2107,1592,3699
162,162,162,162,2021-07-11,Kelantan,1288,1831,3119
163,163,163,163,2021-07-11,Melaka,787,2067,2854
164,164,164,164,2021-07-11,Negeri Sembilan,1441,5291,6732
165,165,165,165,2021-07-11,Pahang,943,3704,4647
166,166,166,166,2021-07-11,Perak,869,1621,2490
167,167,167,167,2021-07-11,Perlis,60,13,73
168,168,168,168,2021-07-11,Pulau Pinang,1859,1457,3316
169,169,169,169,2021-07-11,Sabah,2639,3572,6211
170,170,170,170,2021-07-11,Sarawak,1023,4273,5296
171,171,171,171,2021-07-11,Selangor,18177,17406,35583
172,172,172,172,2021-07-11,Terengganu,1332,1660,2992
173,173,173,173,2021-07-11,W.P. Kuala Lumpur,3463,6758,10221
174,174,174,174,2021-07-11,W.P. Labuan,713,197,910
175,175,175,175,2021-07-11,W.P. Putrajaya,84,423,507
176,176,176,176,2021-07-12,Johor,4266,4710,8976
177,177,177,177,2021-07-12,Kedah,3034,1670,4704
178,178,178,178,2021-07-12,Kelantan,1269,2634,3903
179,179,179,179,2021-07-12,Melaka,1838,3474,5312
180,180,180,180,2021-07-12,Negeri Sembilan,2538,2763,5301
181,181,181,181,2021-07-12,Pahang,3559,4739,8298
182,182,182,182,2021-07-12,Perak,2437,1986,4423
183,183,183,183,2021-07-12,Perlis,129,14,143
184,184,184,184,2021-07-12,Pulau Pinang,4283,1496,5779
185,185,185,185,2021-07-12,Sabah,4038,3467,7505
186,186,186,186,2021-07-12,Sarawak,1804,5779,7583
187,187,187,187,2021-07-12,Selangor,30965,14178,45143
188,188,188,188,2021-07-12,Terengganu,1294,1616,2910
189,189,189,189,2021-07-12,W.P. Kuala Lumpur,798,6292,7090
190,190,190,190,2021-07-12,W.P. Labuan,910,136,1046
191,191,191,191,2021-07-12,W.P. Putrajaya,195,366,561
192,192,192,192,2021-07-13,Johor,5440,4425,9865
193,193,193,193,2021-07-13,Kedah,3237,2403,5640
194,194,194,194,2021-07-13,Kelantan,1222,2128,3350
195,195,195,195,2021-07-13,Melaka,1890,2752,4642
196,196,196,196,2021-07-13,Negeri Sembilan,2350,4669,7019
197,197,197,197,2021-07-13,Pahang,4025,3363,7388
198,198,198,198,2021-07-13,Perak,2096,2335,4431
199,199,199,199,2021-07-13,Perlis,83,43,126
200,200,200,200,2021-07-13,Pulau Pinang,3272,3209,6481
201,201,201,201,2021-07-13,Sabah,3167,4216,7383
202,202,202,202,2021-07-13,Sarawak,1225,7430,8655
203,203,203,203,2021-07-13,Selangor,35422,17922,53344
204,204,204,204,2021-07-13,Terengganu,976,1666,2642
205,205,205,205,2021-07-13,W.P. Kuala Lumpur,6444,9443,15887
206,206,206,206,2021-07-13,W.P. Labuan,549,240,789
207,207,207,207,2021-07-13,W.P. Putrajaya,260,462,722
208,208,208,208,2021-07-14,Johor,6691,4914,11605
209,209,209,209,2021-07-14,Kedah,2615,2711,5326
210,210,210,210,2021-07-14,Kelantan,2078,2325,4403
211,211,211,211,2021-07-14,Melaka,1813,3380,5193
212,212,212,212,2021-07-14,Negeri Sembilan,3270,7137,10407
213,213,213,213,2021-07-14,Pahang,1788,2727,4515
214,214,214,214,2021-07-14,Perak,2053,2832,4885
215,215,215,215,2021-07-14,Perlis,130,56,186
216,216,216,216,2021-07-14,Pulau Pinang,4525,2350,6875
217,217,217,217,2021-07-14,Sabah,3090,3842,6932
218,218,218,218,2021-07-14,Sarawak,1895,5822,7717
219,219,219,219,2021-07-14,Selangor,32711,20174,52885
220,220,220,220,2021-07-14,Terengganu,1199,1381,2580
221,221,221,221,2021-07-14,W.P. Kuala Lumpur,6762,9616,16378
222,222,222,222,2021-07-14,W.P. Labuan,650,145,795
223,223,223,223,2021-07-14,W.P. Putrajaya,305,657,962
224,224,224,224,2021-07-15,Johor,8222,4906,13128
225,225,225,225,2021-07-15,Kedah,2541,2369,4910
226,226,226,226,2021-07-15,Kelantan,2231,2305,4536
227,227,227,227,2021-07-15,Melaka,1861,5157,7018
228,228,228,228,2021-07-15,Negeri Sembilan,3078,5556,8634
229,229,229,229,2021-07-15,Pahang,2107,2908,5015
230,230,230,230,2021-07-15,Perak,2114,3549,5663
231,231,231,231,2021-07-15,Perlis,138,45,183
232,232,232,232,2021-07-15,Pulau Pinang,4269,2444,6713
233,233,233,233,2021-07-15,Sabah,3767,4168,7935
234,234,234,234,2021-07-15,Sarawak,1237,6188,7425
235,235,235,235,2021-07-15,Selangor,35710,20791,56501
236,236,236,236,2021-07-15,Terengganu,1423,1879,3302
237,237,237,237,2021-07-15,W.P. Kuala Lumpur,8109,11426,19535
238,238,238,238,2021-07-15,W.P. Labuan,645,434,1079
239,239,239,239,2021-07-15,W.P. Putrajaya,249,130,379
240,240,240,240,2021-07-16,Johor,5341,6175,11516
241,241,241,241,2021-07-16,Kedah,2223,2785,5008
242,242,242,242,2021-07-16,Kelantan,617,2250,2867
243,243,243,243,2021-07-16,Melaka,1914,5059,6973
244,244,244,244,2021-07-16,Negeri Sembilan,3764,5279,9043
245,245,245,245,2021-07-16,Pahang,3328,4097,7425
246,246,246,246,2021-07-16,Perak,2354,2976,5330
247,247,247,247,2021-07-16,Perlis,91,29,120
248,248,248,248,2021-07-16,Pulau Pinang,4399,2879,7278
249,249,249,249,2021-07-16,Sabah,3073,4269,7342
250,250,250,250,2021-07-16,Sarawak,1524,7361,8885
251,251,251,251,2021-07-16,Selangor,29831,19974,49805
252,252,252,252,2021-07-16,Terengganu,879,2215,3094
253,253,253,253,2021-07-16,W.P. Kuala Lumpur,8451,9141,17592
254,254,254,254,2021-07-16,W.P. Labuan,645,92,737
255,255,255,255,2021-07-16,W.P. Putrajaya,225,509,734
256,256,256,256,2021-07-17,Johor,5267,5424,10691
257,257,257,257,2021-07-17,Kedah,2715,2158,4873
258,258,258,258,2021-07-17,Kelantan,896,2841,3737
259,259,259,259,2021-07-17,Melaka,1343,3091,4434
260,260,260,260,2021-07-17,Negeri Sembilan,2414,5058,7472
261,261,261,261,2021-07-17,Pahang,2209,3239,5448
262,262,262,262,2021-07-17,Perak,2362,2290,4652
263,263,263,263,2021-07-17,Perlis,44,58,102
264,264,264,264,2021-07-17,Pulau Pinang,4257,2985,7242
265,265,265,265,2021-07-17,Sabah,3091,4916,8007
266,266,266,266,2021-07-17,Sarawak,2002,6023,8025
267,267,267,267,2021-07-17,Selangor,24264,22032,46296
268,268,268,268,2021-07-17,Terengganu,1414,1960,3374
269,269,269,269,2021-07-17,W.P. Kuala Lumpur,6280,13078,19358
270,270,270,270,2021-07-17,W.P. Labuan,940,145,1085
271,271,271,271,2021-07-17,W.P. Putrajaya,104,391,495
272,272,272,272,2021-07-18,Johor,3591,4435,8026
273,273,273,273,2021-07-18,Kedah,3201,1669,4870
274,274,274,274,2021-07-18,Kelantan,1857,2531,4388
275,275,275,275,2021-07-18,Melaka,903,3672,4575
276,276,276,276,2021-07-18,Negeri Sembilan,1614,4637,6251
277,277,277,277,2021-07-18,Pahang,1981,2739,4720
278,278,278,278,2021-07-18,Perak,1250,2209,3459
279,279,279,279,2021-07-18,Perlis,70,24,94
280,280,280,280,2021-07-18,Pulau Pinang,3968,2762,6730
281,281,281,281,2021-07-18,Sabah,2695,4294,6989
282,282,282,282,2021-07-18,Sarawak,1090,6229,7319
283,283,283,283,2021-07-18,Selangor,22031,14924,36955
284,284,284,284,2021-07-18,Terengganu,1356,998,2354
285,285,285,285,2021-07-18,W.P. Kuala Lumpur,3985,7774,11759
286,286,286,286,2021-07-18,W.P. Labuan,572,260,832
287,287,287,287,2021-07-18,W.P. Putrajaya,78,612,690
288,288,288,288,2021-07-19,Johor,4797,4324,9121
289,289,289,289,2021-07-19,Kedah,3283,3699,6982
290,290,290,290,2021-07-19,Kelantan,1504,3001,4505
291,291,291,291,2021-07-19,Melaka,1719,1902,3621
292,292,292,292,2021-07-19,Negeri Sembilan,2977,3832,6809
293,293,293,293,2021-07-19,Pahang,2717,3950,6667
294,294,294,294,2021-07-19,Perak,2803,2274,5077
295,295,295,295,2021-07-19,Perlis,138,17,155
296,296,296,296,2021-07-19,Pulau Pinang,5014,1140,6154
297,297,297,297,2021-07-19,Sabah,3865,3014,6879
298,298,298,298,2021-07-19,Sarawak,1990,6816,8806
299,299,299,299,2021-07-19,Selangor,33042,15546,48588
300,300,300,300,2021-07-19,Terengganu,1000,3420,4420
301,301,301,301,2021-07-19,W.P. Kuala Lumpur,7632,7007,14639
302,302,302,302,2021-07-19,W.P. Labuan,620,92,712
303,303,303,303,2021-07-19,W.P. Putrajaya,168,642,810
304,304,304,304,2021-07-20,Johor,1675,4122,5797
305,305,305,305,2021-07-20,Kedah,1740,2136,3876
306,306,306,306,2021-07-20,Kelantan,472,2096,2568
307,307,307,307,2021-07-20,Melaka,839,2448,3287
308,308,308,308,2021-07-20,Negeri Sembilan,1848,3946,5794
309,309,309,309,2021-07-20,Pahang,1095,3671,4766
310,310,310,310,2021-07-20,Perak,1969,2060,4029
311,311,311,311,2021-07-20,Perlis,11,32,43
312,312,312,312,2021-07-20,Pulau Pinang,2096,2388,4484
313,313,313,313,2021-07-20,Sabah,1921,3534,5455
314,314,314,314,2021-07-20,Sarawak,899,5421,6320
315,315,315,315,2021-07-20,Selangor,16949,17683,34632
316,316,316,316,2021-07-20,Terengganu,412,2133,2545
317,317,317,317,2021-07-20,W.P. Kuala Lumpur,3732,8265,11997
318,318,318,318,2021-07-20,W.P. Labuan,236,251,487
319,319,319,319,2021-07-20,W.P. Putrajaya,57,493,550
320,320,320,320,2021-07-21,Johor,5169,3975,9144
321,321,321,321,2021-07-21,Kedah,3436,2864,6300
322,322,322,322,2021-07-21,Kelantan,844,1865,2709
323,323,323,323,2021-07-21,Melaka,2047,2596,4643
324,324,324,324,2021-07-21,Negeri Sembilan,2954,3330,6284
325,325,325,325,2021-07-21,Pahang,2453,2820,5273
326,326,326,326,2021-07-21,Perak,2582,1918,4500
327,327,327,327,2021-07-21,Perlis,32,46,78
328,328,328,328,2021-07-21,Pulau Pinang,4840,1460,6300
329,329,329,329,2021-07-21,Sabah,4382,3558,7940
330,330,330,330,2021-07-21,Sarawak,1437,8791,10228
331,331,331,331,2021-07-21,Selangor,33961,18812,52773
332,332,332,332,2021-07-21,Terengganu,808,2315,3123
333,333,333,333,2021-07-21,W.P. Kuala Lumpur,9530,7396,16926
334,334,334,334,2021-07-21,W.P. Labuan,467,56,523
335,335,335,335,2021-07-21,W.P. Putrajaya,301,248,549
336,336,336,336,2021-07-22,Johor,5229,7005,12234
337,337,337,337,2021-07-22,Kedah,3980,3583,7563
338,338,338,338,2021-07-22,Kelantan,1439,2818,4257
339,339,339,339,2021-07-22,Melaka,1872,1458,3330
340,340,340,340,2021-07-22,Negeri Sembilan,3790,5373,9163
341,341,341,341,2021-07-22,Pahang,3047,2616,5663
342,342,342,342,2021-07-22,Perak,2471,2827,5298
343,343,343,343,2021-07-22,Perlis,202,17,219
344,344,344,344,2021-07-22,Pulau Pinang,5551,3271,8822
345,345,345,345,2021-07-22,Sabah,4963,3109,8072
346,346,346,346,2021-07-22,Sarawak,923,6545,7468
347,347,347,347,2021-07-22,Selangor,34071,21675,55746
348,348,348,348,2021-07-22,Terengganu,1576,3452,5028
349,349,349,349,2021-07-22,W.P. Kuala Lumpur,8864,11811,20675
350,350,350,350,2021-07-22,W.P. Labuan,594,97,691
351,351,351,351,2021-07-22,W.P. Putrajaya,375,385,760
352,352,352,352,2021-07-23,Johor,5212,6872,12084
353,353,353,353,2021-07-23,Kedah,3311,2973,6284
354,354,354,354,2021-07-23,Kelantan,768,3119,3887
355,355,355,355,2021-07-23,Melaka,2035,4219,6254
356,356,356,356,2021-07-23,Negeri Sembilan,4583,4295,8878
357,357,357,357,2021-07-23,Pahang,2313,3727,6040
358,358,358,358,2021-07-23,Perak,2409,3657,6066
359,359,359,359,2021-07-23,Perlis,157,48,205
360,360,360,360,2021-07-23,Pulau Pinang,5819,3079,8898
361,361,361,361,2021-07-23,Sabah,4186,4935,9121
362,362,362,362,2021-07-23,Sarawak,1393,6541,7934
363,363,363,363,2021-07-23,Selangor,31344,23350,54694
364,364,364,364,2021-07-23,Terengganu,1070,2189,3259
365,365,365,365,2021-07-23,W.P. Kuala Lumpur,10226,10922,21148
366,366,366,366,2021-07-23,W.P. Labuan,248,139,387
367,367,367,367,2021-07-23,W.P. Putrajaya,676,628,1304
368,368,368,368,2021-07-24,Johor,5914,5093,11007
369,369,369,369,2021-07-24,Kedah,3048,2026,5074
370,370,370,370,2021-07-24,Kelantan,1006,2668,3674
371,371,371,371,2021-07-24,Melaka,1508,2902,4410
372,372,372,372,2021-07-24,Negeri Sembilan,2711,4749,7460
373,373,373,373,2021-07-24,Pahang,2480,3041,5521
374,374,374,374,2021-07-24,Perak,2652,2151,4803
375,375,375,375,2021-07-24,Perlis,50,55,105
376,376,376,376,2021-07-24,Pulau Pinang,4780,2803,7583
377,377,377,377,2021-07-24,Sabah,3471,4616,8087
378,378,378,378,2021-07-24,Sarawak,2248,5655,7903
379,379,379,379,2021-07-24,Selangor,27243,20688,47931
380,380,380,380,2021-07-24,Terengganu,1588,1841,3429
381,381,381,381,2021-07-24,W.P. Kuala Lumpur,7051,12280,19331
382,382,382,382,2021-07-24,W.P. Labuan,1056,136,1192
383,383,383,383,2021-07-24,W.P. Putrajaya,117,367,484
384,384,384,384,2021-07-25,Johor,3772,4975,8747
385,385,385,385,2021-07-25,Kedah,3362,1872,5234
386,386,386,386,2021-07-25,Kelantan,1950,2839,4789
387,387,387,387,2021-07-25,Melaka,948,4119,5067
388,388,388,388,2021-07-25,Negeri Sembilan,1695,5202,6897
389,389,389,389,2021-07-25,Pahang,2081,3072,5153
390,390,390,390,2021-07-25,Perak,1313,2478,3791
391,391,391,391,2021-07-25,Perlis,73,26,99
392,392,392,392,2021-07-25,Pulau Pinang,4168,3099,7267
393,393,393,393,2021-07-25,Sabah,2831,4817,7648
394,394,394,394,2021-07-25,Sarawak,1145,6988,8133
395,395,395,395,2021-07-25,Selangor,23141,16742,39883
396,396,396,396,2021-07-25,Terengganu,1424,1120,2544
397,397,397,397,2021-07-25,W.P. Kuala Lumpur,4186,8720,12906
398,398,398,398,2021-07-25,W.P. Labuan,601,291,892
399,399,399,399,2021-07-25,W.P. Putrajaya,82,687,769
400,400,400,400,2021-07-26,Johor,5973,4131,10104
401,401,401,401,2021-07-26,Kedah,4088,3534,7622
402,402,402,402,2021-07-26,Kelantan,1873,2867,4740
403,403,403,403,2021-07-26,Melaka,2140,1818,3958
404,404,404,404,2021-07-26,Negeri Sembilan,3707,3661,7368
405,405,405,405,2021-07-26,Pahang,3383,3774,7157
406,406,406,406,2021-07-26,Perak,3490,2173,5663
407,407,407,407,2021-07-26,Perlis,172,16,188
408,408,408,408,2021-07-26,Pulau Pinang,6243,1089,7332
409,409,409,409,2021-07-26,Sabah,4813,2879,7692
410,410,410,410,2021-07-26,Sarawak,2478,6512,8990
411,411,411,411,2021-07-26,Selangor,41143,14854,55997
412,412,412,412,2021-07-26,Terengganu,1245,3268,4513
413,413,413,413,2021-07-26,W.P. Kuala Lumpur,9503,6695,16198
414,414,414,414,2021-07-26,W.P. Labuan,772,87,859
415,415,415,415,2021-07-26,W.P. Putrajaya,209,613,822
416,416,416,416,2021-07-27,Johor,5285,5864,11149
417,417,417,417,2021-07-27,Kedah,4419,3055,7474
418,418,418,418,2021-07-27,Kelantan,1544,4059,5603
419,419,419,419,2021-07-27,Melaka,2782,2033,4815
420,420,420,420,2021-07-27,Negeri Sembilan,3217,3643,6860
421,421,421,421,2021-07-27,Pahang,2689,4436,7125
422,422,422,422,2021-07-27,Perak,4204,2498,6702
423,423,423,423,2021-07-27,Perlis,139,37,176
424,424,424,424,2021-07-27,Pulau Pinang,6402,3163,9565
425,425,425,425,2021-07-27,Sabah,4601,4281,8882
426,426,426,426,2021-07-27,Sarawak,1828,6476,8304
427,427,427,427,2021-07-27,Selangor,34615,17693,52308
428,428,428,428,2021-07-27,Terengganu,1637,4810,6447
429,429,429,429,2021-07-27,W.P. Kuala Lumpur,9748,7731,17479
430,430,430,430,2021-07-27,W.P. Labuan,1028,243,1271
431,431,431,431,2021-07-27,W.P. Putrajaya,9,403,412
432,432,432,432,2021-07-28,Johor,5390,5839,11229
433,433,433,433,2021-07-28,Kedah,4552,2978,7530
434,434,434,434,2021-07-28,Kelantan,1670,5242,6912
435,435,435,435,2021-07-28,Melaka,2264,2783,5047
436,436,436,436,2021-07-28,Negeri Sembilan,3023,3002,6025
437,437,437,437,2021-07-28,Pahang,2563,4142,6705
438,438,438,438,2021-07-28,Perak,5282,3920,9202
439,439,439,439,2021-07-28,Perlis,202,66,268
440,440,440,440,2021-07-28,Pulau Pinang,5812,3816,9628
441,441,441,441,2021-07-28,Sabah,4233,4570,8803
442,442,442,442,2021-07-28,Sarawak,1472,7412,8884
443,443,443,443,2021-07-28,Selangor,30417,16753,47170
444,444,444,444,2021-07-28,Terengganu,1892,4012,5904
445,445,445,445,2021-07-28,W.P. Kuala Lumpur,8454,8220,16674
446,446,446,446,2021-07-28,W.P. Labuan,364,129,493
447,447,447,447,2021-07-28,W.P. Putrajaya,208,616,824
448,448,448,448,2021-07-29,Johor,5591,7597,13188
449,449,449,449,2021-07-29,Kedah,3807,3915,7722
450,450,450,450,2021-07-29,Kelantan,1807,4098,5905
451,451,451,451,2021-07-29,Melaka,2328,3125,5453
452,452,452,452,2021-07-29,Negeri Sembilan,3143,3529,6672
453,453,453,453,2021-07-29,Pahang,3261,4012,7273
454,454,454,454,2021-07-29,Perak,4324,4892,9216
455,455,455,455,2021-07-29,Perlis,168,72,240
456,456,456,456,2021-07-29,Pulau Pinang,5994,3295,9289
457,457,457,457,2021-07-29,Sabah,4973,7133,12106
458,458,458,458,2021-07-29,Sarawak,1424,6244,7668
459,459,459,459,2021-07-29,Selangor,30712,18131,48843
460,460,460,460,2021-07-29,Terengganu,2043,3554,5597
461,461,461,461,2021-07-29,W.P. Kuala Lumpur,8730,10404,19134
462,462,462,462,2021-07-29,W.P. Labuan,487,51,538
463,463,463,463,2021-07-29,W.P. Putrajaya,209,347,556
464,464,464,464,2021-07-30,Johor,3887,10180,14067
465,465,465,465,2021-07-30,Kedah,4110,3653,7763
466,466,466,466,2021-07-30,Kelantan,1815,4438,6253
467,467,467,467,2021-07-30,Melaka,1745,3157,4902
468,468,468,468,2021-07-30,Negeri Sembilan,2757,3214,5971
469,469,469,469,2021-07-30,Pahang,2178,4229,6407
470,470,470,470,2021-07-30,Perak,4202,3889,8091
471,471,471,471,2021-07-30,Perlis,153,211,364
472,472,472,472,2021-07-30,Pulau Pinang,8789,3601,12390
473,473,473,473,2021-07-30,Sabah,4518,6873,11391
474,474,474,474,2021-07-30,Sarawak,1468,6036,7504
475,475,475,475,2021-07-30,Selangor,28906,17425,46331
476,476,476,476,2021-07-30,Terengganu,883,6473,7356
477,477,477,477,2021-07-30,W.P. Kuala Lumpur,6654,7600,14254
478,478,478,478,2021-07-30,W.P. Labuan,520,55,575
479,479,479,479,2021-07-30,W.P. Putrajaya,222,757,979
480,480,480,480,2021-07-31,Johor,5169,9017,14186
481,481,481,481,2021-07-31,Kedah,3300,3821,7121
482,482,482,482,2021-07-31,Kelantan,1572,2242,3814
483,483,483,483,2021-07-31,Melaka,1707,3289,4996
484,484,484,484,2021-07-31,Negeri Sembilan,2522,4313,6835
485,485,485,485,2021-07-31,Pahang,2037,2415,4452
486,486,486,486,2021-07-31,Perak,3339,4055,7394
487,487,487,487,2021-07-31,Perlis,111,166,277
488,488,488,488,2021-07-31,Pulau Pinang,6615,3771,10386
489,489,489,489,2021-07-31,Sabah,4607,5884,10491
490,490,490,490,2021-07-31,Sarawak,1354,4774,6128
491,491,491,491,2021-07-31,Selangor,23177,16831,40008
492,492,492,492,2021-07-31,Terengganu,1814,3369,5183
493,493,493,493,2021-07-31,W.P. Kuala Lumpur,5528,8439,13967
494,494,494,494,2021-07-31,W.P. Labuan,313,108,421
495,495,495,495,2021-07-31,W.P. Putrajaya,151,403,554
496,496,496,496,2021-08-01,Johor,5557,6913,12470
497,497,497,497,2021-08-01,Kedah,4162,2175,6337
498,498,498,498,2021-08-01,Kelantan,2908,2657,5565
499,499,499,499,2021-08-01,Melaka,1323,2228,3551
500,500,500,500,2021-08-01,Negeri Sembilan,1741,2835,4576
501,501,501,501,2021-08-01,Pahang,1933,4227,6160
502,502,502,502,2021-08-01,Perak,2153,2545,4698
503,503,503,503,2021-08-01,Perlis,85,153,238
504,504,504,504,2021-08-01,Pulau Pinang,3293,2372,5665
505,505,505,505,2021-08-01,Sabah,3792,5190,8982
506,506,506,506,2021-08-01,Sarawak,867,4285,5152
507,507,507,507,2021-08-01,Selangor,17569,11667,29236
508,508,508,508,2021-08-01,Terengganu,2177,2585,4762
509,509,509,509,2021-08-01,W.P. Kuala Lumpur,4046,4377,8423
510,510,510,510,2021-08-01,W.P. Labuan,419,141,560
511,511,511,511,2021-08-01,W.P. Putrajaya,83,382,465
512,512,512,512,2021-08-02,Johor,6665,5269,11934
513,513,513,513,2021-08-02,Kedah,5318,2704,8022
514,514,514,514,2021-08-02,Kelantan,2554,3209,5763
515,515,515,515,2021-08-02,Melaka,2326,2387,4713
516,516,516,516,2021-08-02,Negeri Sembilan,4334,1531,5865
517,517,517,517,2021-08-02,Pahang,2831,3033,5864
518,518,518,518,2021-08-02,Perak,4104,3333,7437
519,519,519,519,2021-08-02,Perlis,244,43,287
520,520,520,520,2021-08-02,Pulau Pinang,5425,2941,8366
521,521,521,521,2021-08-02,Sabah,6929,5154,12083
522,522,522,522,2021-08-02,Sarawak,2816,6584,9400
523,523,523,523,2021-08-02,Selangor,33372,11352,44724
524,524,524,524,2021-08-02,Terengganu,2339,3656,5995
525,525,525,525,2021-08-02,W.P. Kuala Lumpur,8903,5665,14568
526,526,526,526,2021-08-02,W.P. Labuan,562,88,650
527,527,527,527,2021-08-02,W.P. Putrajaya,292,313,605
528,528,528,528,2021-08-03,Johor,7078,9142,16220
529,529,529,529,2021-08-03,Kedah,4516,3776,8292
530,530,530,530,2021-08-03,Kelantan,3350,4202,7552
531,531,531,531,2021-08-03,Melaka,2266,3171,5437
532,532,532,532,2021-08-03,Negeri Sembilan,3182,3208,6390
533,533,533,533,2021-08-03,Pahang,2220,3135,5355
534,534,534,534,2021-08-03,Perak,4123,4109,8232
535,535,535,535,2021-08-03,Perlis,135,141,276
536,536,536,536,2021-08-03,Pulau Pinang,7466,3920,11386
537,537,537,537,2021-08-03,Sabah,6367,6934,13301
538,538,538,538,2021-08-03,Sarawak,1540,8682,10222
539,539,539,539,2021-08-03,Selangor,32708,21840,54548
540,540,540,540,2021-08-03,Terengganu,1707,3186,4893
541,541,541,541,2021-08-03,W.P. Kuala Lumpur,8402,8616,17018
542,542,542,542,2021-08-03,W.P. Labuan,344,306,650
543,543,543,543,2021-08-03,W.P. Putrajaya,161,547,708
544,544,544,544,2021-08-04,Johor,6979,9027,16006
545,545,545,545,2021-08-04,Kedah,4255,3558,7813
546,546,546,546,2021-08-04,Kelantan,3347,2870,6217
547,547,547,547,2021-08-04,Melaka,1977,2754,4731
548,548,548,548,2021-08-04,Negeri Sembilan,2680,2661,5341
549,549,549,549,2021-08-04,Pahang,2362,4843,7205
550,550,550,550,2021-08-04,Perak,4272,4011,8283
551,551,551,551,2021-08-04,Perlis,142,89,231
552,552,552,552,2021-08-04,Pulau Pinang,7962,3599,11561
553,553,553,553,2021-08-04,Sabah,6610,5116,11726
554,554,554,554,2021-08-04,Sarawak,2042,7783,9825
555,555,555,555,2021-08-04,Selangor,30422,16355,46777
556,556,556,556,2021-08-04,Terengganu,1796,3525,5321
557,557,557,557,2021-08-04,W.P. Kuala Lumpur,7883,7650,15533
558,558,558,558,2021-08-04,W.P. Labuan,348,225,573
559,559,559,559,2021-08-04,W.P. Putrajaya,271,471,742
560,560,560,560,2021-08-05,Johor,6941,8962,15903
561,561,561,561,2021-08-05,Kedah,4902,3350,8252
562,562,562,562,2021-08-05,Kelantan,3789,3698,7487
563,563,563,563,2021-08-05,Melaka,2465,2323,4788
564,564,564,564,2021-08-05,Negeri Sembilan,2461,2354,4815
565,565,565,565,2021-08-05,Pahang,2247,4731,6978
566,566,566,566,2021-08-05,Perak,3403,2943,6346
567,567,567,567,2021-08-05,Perlis,232,38,270
568,568,568,568,2021-08-05,Pulau Pinang,7843,3744,11587
569,569,569,569,2021-08-05,Sabah,6536,4894,11430
570,570,570,570,2021-08-05,Sarawak,2568,6609,9177
571,571,571,571,2021-08-05,Selangor,28657,15902,44559
572,572,572,572,2021-08-05,Terengganu,2113,3531,5644
573,573,573,573,2021-08-05,W.P. Kuala Lumpur,8451,7906,16357
574,574,574,574,2021-08-05,W.P. Labuan,256,174,430
575,575,575,575,2021-08-05,W.P. Putrajaya,196,167,363
576,576,576,576,2021-08-06,Johor,8219,10156,18375
577,577,577,577,2021-08-06,Kedah,4336,3484,7820
578,578,578,578,2021-08-06,Kelantan,2078,3281,5359
579,579,579,579,2021-08-06,Melaka,2793,2259,5052
580,580,580,580,2021-08-06,Negeri Sembilan,2789,3430,6219
581,581,581,581,2021-08-06,Pahang,2484,4609,7093
582,582,582,582,2021-08-06,Perak,3621,2915,6536
583,583,583,583,2021-08-06,Perlis,216,90,306
584,584,584,584,2021-08-06,Pulau Pinang,6874,3520,10394
585,585,585,585,2021-08-06,Sabah,5732,5683,11415
586,586,586,586,2021-08-06,Sarawak,2616,8358,10974
587,587,587,587,2021-08-06,Selangor,28713,16919,45632
588,588,588,588,2021-08-06,Terengganu,1213,4831,6044
589,589,589,589,2021-08-06,W.P. Kuala Lumpur,7538,7866,15404
590,590,590,590,2021-08-06,W.P. Labuan,271,122,393
591,591,591,591,2021-08-06,W.P. Putrajaya,244,352,596
592,592,592,592,2021-08-07,Johor,8393,10521,18914
593,593,593,593,2021-08-07,Kedah,4134,3631,7765
594,594,594,594,2021-08-07,Kelantan,3223,2662,5885
595,595,595,595,2021-08-07,Melaka,1712,1993,3705
596,596,596,596,2021-08-07,Negeri Sembilan,1581,2480,4061
597,597,597,597,2021-08-07,Pahang,3252,3480,6732
598,598,598,598,2021-08-07,Perak,3883,2884,6767
599,599,599,599,2021-08-07,Perlis,87,40,127
600,600,600,600,2021-08-07,Pulau Pinang,7097,3835,10932
601,601,601,601,2021-08-07,Sabah,5219,5147,10366
602,602,602,602,2021-08-07,Sarawak,2036,6625,8661
603,603,603,603,2021-08-07,Selangor,23481,16975,40456
604,604,604,604,2021-08-07,Terengganu,1520,4117,5637
605,605,605,605,2021-08-07,W.P. Kuala Lumpur,5585,8381,13966
606,606,606,606,2021-08-07,W.P. Labuan,226,322,548
607,607,607,607,2021-08-07,W.P. Putrajaya,125,302,427
608,608,608,608,2021-08-08,Johor,8855,8434,17289
609,609,609,609,2021-08-08,Kedah,4925,2856,7781
610,610,610,610,2021-08-08,Kelantan,4449,2080,6529
611,611,611,611,2021-08-08,Melaka,1450,2634,4084
612,612,612,612,2021-08-08,Negeri Sembilan,1512,1975,3487
613,613,613,613,2021-08-08,Pahang,2185,3718,5903
614,614,614,614,2021-08-08,Perak,2605,2595,5200
615,615,615,615,2021-08-08,Perlis,223,74,297
616,616,616,616,2021-08-08,Pulau Pinang,4436,3510,7946
617,617,617,617,2021-08-08,Sabah,3831,6140,9971
618,618,618,618,2021-08-08,Sarawak,2308,6966,9274
619,619,619,619,2021-08-08,Selangor,16802,12971,29773
620,620,620,620,2021-08-08,Terengganu,2265,4392,6657
621,621,621,621,2021-08-08,W.P. Kuala Lumpur,3057,4865,7922
622,622,622,622,2021-08-08,W.P. Labuan,414,262,676
623,623,623,623,2021-08-08,W.P. Putrajaya,84,187,271
624,624,624,624,2021-08-09,Johor,9952,6964,16916
625,625,625,625,2021-08-09,Kedah,5749,3966,9715
626,626,626,626,2021-08-09,Kelantan,5207,2358,7565
627,627,627,627,2021-08-09,Melaka,2739,1964,4703
628,628,628,628,2021-08-09,Negeri Sembilan,3498,1544,5042
629,629,629,629,2021-08-09,Pahang,3539,4011,7550
630,630,630,630,2021-08-09,Perak,4294,3032,7326
631,631,631,631,2021-08-09,Perlis,426,48,474
632,632,632,632,2021-08-09,Pulau Pinang,7057,2751,9808
633,633,633,633,2021-08-09,Sabah,6928,5910,12838
634,634,634,634,2021-08-09,Sarawak,1723,7150,8873
635,635,635,635,2021-08-09,Selangor,33032,9926,42958
636,636,636,636,2021-08-09,Terengganu,2279,3343,5622
637,637,637,637,2021-08-09,W.P. Kuala Lumpur,8960,4253,13213
638,638,638,638,2021-08-09,W.P. Labuan,425,69,494
639,639,639,639,2021-08-09,W.P. Putrajaya,213,252,465
640,640,640,640,2021-08-10,Johor,9446,8548,17994
641,641,641,641,2021-08-10,Kedah,3606,3648,7254
642,642,642,642,2021-08-10,Kelantan,2947,1671,4618
643,643,643,643,2021-08-10,Melaka,1842,2400,4242
644,644,644,644,2021-08-10,Negeri Sembilan,1954,2321,4275
645,645,645,645,2021-08-10,Pahang,1969,4373,6342
646,646,646,646,2021-08-10,Perak,2409,4058,6467
647,647,647,647,2021-08-10,Perlis,124,105,229
648,648,648,648,2021-08-10,Pulau Pinang,5716,4098,9814
649,649,649,649,2021-08-10,Sabah,4597,5698,10295
650,650,650,650,2021-08-10,Sarawak,1239,10501,11740
651,651,651,651,2021-08-10,Selangor,22847,19068,41915
652,652,652,652,2021-08-10,Terengganu,1342,4863,6205
653,653,653,653,2021-08-10,W.P. Kuala Lumpur,4641,7617,12258
654,654,654,654,2021-08-10,W.P. Labuan,162,346,508
655,655,655,655,2021-08-10,W.P. Putrajaya,59,350,409
656,656,656,656,2021-08-11,Johor,10637,8145,18782
657,657,657,657,2021-08-11,Kedah,6669,4240,10909
658,658,658,658,2021-08-11,Kelantan,4804,2373,7177
659,659,659,659,2021-08-11,Melaka,2611,2249,4860
660,660,660,660,2021-08-11,Negeri Sembilan,2922,1673,4595
661,661,661,661,2021-08-11,Pahang,3067,5322,8389
662,662,662,662,2021-08-11,Perak,4927,2882,7809
663,663,663,663,2021-08-11,Perlis,318,102,420
664,664,664,664,2021-08-11,Pulau Pinang,7425,3009,10434
665,665,665,665,2021-08-11,Sabah,7401,6704,14105
666,666,666,666,2021-08-11,Sarawak,2201,12372,14573
667,667,667,667,2021-08-11,Selangor,30236,14588,44824
668,668,668,668,2021-08-11,Terengganu,2258,4133,6391
669,669,669,669,2021-08-11,W.P. Kuala Lumpur,9198,7085,16283
670,670,670,670,2021-08-11,W.P. Labuan,303,164,467
671,671,671,671,2021-08-11,W.P. Putrajaya,237,237,474
672,672,672,672,2021-08-12,Johor,11670,11468,23138
673,673,673,673,2021-08-12,Kedah,6075,4148,10223
674,674,674,674,2021-08-12,Kelantan,5288,2488,7776
675,675,675,675,2021-08-12,Melaka,2930,2711,5641
676,676,676,676,2021-08-12,Negeri Sembilan,2444,2895,5339
677,677,677,677,2021-08-12,Pahang,2640,5318,7958
678,678,678,678,2021-08-12,Perak,4930,4270,9200
679,679,679,679,2021-08-12,Perlis,327,129,456
680,680,680,680,2021-08-12,Pulau Pinang,8160,4621,12781
681,681,681,681,2021-08-12,Sabah,8239,4833,13072
682,682,682,682,2021-08-12,Sarawak,2167,9313,11480
683,683,683,683,2021-08-12,Selangor,28066,21445,49511
684,684,684,684,2021-08-12,Terengganu,2266,3820,6086
685,685,685,685,2021-08-12,W.P. Kuala Lumpur,7585,9644,17229
686,686,686,686,2021-08-12,W.P. Labuan,318,249,567
687,687,687,687,2021-08-12,W.P. Putrajaya,353,428,781
688,688,688,688,2021-08-13,Johor,9617,11029,20646
689,689,689,689,2021-08-13,Kedah,4262,4240,8502
690,690,690,690,2021-08-13,Kelantan,4590,2696,7286
691,691,691,691,2021-08-13,Melaka,2376,3643,6019
692,692,692,692,2021-08-13,Negeri Sembilan,2881,2395,5276
693,693,693,693,2021-08-13,Pahang,2426,5328,7754
694,694,694,694,2021-08-13,Perak,5198,3609,8807
695,695,695,695,2021-08-13,Perlis,360,132,492
696,696,696,696,2021-08-13,Pulau Pinang,8732,3808,12540
697,697,697,697,2021-08-13,Sabah,7461,6824,14285
698,698,698,698,2021-08-13,Sarawak,1831,7611,9442
699,699,699,699,2021-08-13,Selangor,26078,19986,46064
700,700,700,700,2021-08-13,Terengganu,860,3733,4593
701,701,701,701,2021-08-13,W.P. Kuala Lumpur,7463,7545,15008
702,702,702,702,2021-08-13,W.P. Labuan,293,139,432
703,703,703,703,2021-08-13,W.P. Putrajaya,167,380,547
704,704,704,704,2021-08-14,Johor,9664,10284,19948
705,705,705,705,2021-08-14,Kedah,4473,3511,7984
706,706,706,706,2021-08-14,Kelantan,4309,2106,6415
707,707,707,707,2021-08-14,Melaka,1933,3438,5371
708,708,708,708,2021-08-14,Negeri Sembilan,2261,2600,4861
709,709,709,709,2021-08-14,Pahang,2132,5237,7369
710,710,710,710,2021-08-14,Perak,4631,3354,7985
711,711,711,711,2021-08-14,Perlis,186,123,309
712,712,712,712,2021-08-14,Pulau Pinang,9234,5130,14364
713,713,713,713,2021-08-14,Sabah,6865,9744,16609
714,714,714,714,2021-08-14,Sarawak,2881,6459,9340
715,715,715,715,2021-08-14,Selangor,21336,16792,38128
716,716,716,716,2021-08-14,Terengganu,1570,3327,4897
717,717,717,717,2021-08-14,W.P. Kuala Lumpur,4649,7182,11831
718,718,718,718,2021-08-14,W.P. Labuan,289,250,539
719,719,719,719,2021-08-14,W.P. Putrajaya,71,400,471
720,720,720,720,2021-08-15,Johor,10384,8051,18435
721,721,721,721,2021-08-15,Kedah,5490,3835,9325
722,722,722,722,2021-08-15,Kelantan,5972,2140,8112
723,723,723,723,2021-08-15,Melaka,1065,2929,3994
724,724,724,724,2021-08-15,Negeri Sembilan,1519,2480,3999
725,725,725,725,2021-08-15,Pahang,1724,4825,6549
726,726,726,726,2021-08-15,Perak,4223,3114,7337
727,727,727,727,2021-08-15,Perlis,270,79,349
728,728,728,728,2021-08-15,Pulau Pinang,6100,3397,9497
729,729,729,729,2021-08-15,Sabah,5079,7746,12825
730,730,730,730,2021-08-15,Sarawak,1587,10632,12219
731,731,731,731,2021-08-15,Selangor,14454,13210,27664
732,732,732,732,2021-08-15,Terengganu,2487,3829,6316
733,733,733,733,2021-08-15,W.P. Kuala Lumpur,3153,4428,7581
734,734,734,734,2021-08-15,W.P. Labuan,281,274,555
735,735,735,735,2021-08-15,W.P. Putrajaya,61,212,273
736,736,736,736,2021-08-16,Johor,11872,8174,20046
737,737,737,737,2021-08-16,Kedah,5358,4406,9764
738,738,738,738,2021-08-16,Kelantan,4795,2908,7703
739,739,739,739,2021-08-16,Melaka,2345,2013,4358
740,740,740,740,2021-08-16,Negeri Sembilan,3216,1214,4430
741,741,741,741,2021-08-16,Pahang,2941,4506,7447
742,742,742,742,2021-08-16,Perak,7029,2082,9111
743,743,743,743,2021-08-16,Perlis,329,116,445
744,744,744,744,2021-08-16,Pulau Pinang,9644,2491,12135
745,745,745,745,2021-08-16,Sabah,8092,7276,15368
746,746,746,746,2021-08-16,Sarawak,2529,7738,10267
747,747,747,747,2021-08-16,Selangor,27535,12632,40167
748,748,748,748,2021-08-16,Terengganu,2559,2619,5178
749,749,749,749,2021-08-16,W.P. Kuala Lumpur,7316,5521,12837
750,750,750,750,2021-08-16,W.P. Labuan,451,52,503
751,751,751,751,2021-08-16,W.P. Putrajaya,208,190,398
752,752,752,752,2021-08-17,Johor,11416,11641,23057
753,753,753,753,2021-08-17,Kedah,5547,4192,9739
754,754,754,754,2021-08-17,Kelantan,4733,2447,7180
755,755,755,755,2021-08-17,Melaka,2356,3957,6313
756,756,756,756,2021-08-17,Negeri Sembilan,3321,2314,5635
757,757,757,757,2021-08-17,Pahang,2601,4893,7494
758,758,758,758,2021-08-17,Perak,5501,4653,10154
759,759,759,759,2021-08-17,Perlis,367,130,497
760,760,760,760,2021-08-17,Pulau Pinang,9177,5066,14243
761,761,761,761,2021-08-17,Sabah,7877,6854,14731
762,762,762,762,2021-08-17,Sarawak,2028,11802,13830
763,763,763,763,2021-08-17,Selangor,25154,20177,45331
764,764,764,764,2021-08-17,Terengganu,1943,2678,4621
765,765,765,765,2021-08-17,W.P. Kuala Lumpur,6935,8209,15144
766,766,766,766,2021-08-17,W.P. Labuan,263,331,594
767,767,767,767,2021-08-17,W.P. Putrajaya,190,202,392
768,768,768,768,2021-08-18,Johor,11901,11338,23239
769,769,769,769,2021-08-18,Kedah,5810,5114,10924
770,770,770,770,2021-08-18,Kelantan,4412,2601,7013
771,771,771,771,2021-08-18,Melaka,1916,2435,4351
772,772,772,772,2021-08-18,Negeri Sembilan,2906,2132,5038
773,773,773,773,2021-08-18,Pahang,2280,5332,7612
774,774,774,774,2021-08-18,Perak,5625,3540,9165
775,775,775,775,2021-08-18,Perlis,330,247,577
776,776,776,776,2021-08-18,Pulau Pinang,10038,4838,14876
777,777,777,777,2021-08-18,Sabah,7673,6574,14247
778,778,778,778,2021-08-18,Sarawak,2882,10387,13269
779,779,779,779,2021-08-18,Selangor,25204,17493,42697
780,780,780,780,2021-08-18,Terengganu,1741,3667,5408
781,781,781,781,2021-08-18,W.P. Kuala Lumpur,5735,6671,12406
782,782,782,782,2021-08-18,W.P. Labuan,234,82,316
783,783,783,783,2021-08-18,W.P. Putrajaya,142,370,512
784,784,784,784,2021-08-19,Johor,11147,11187,22334
785,785,785,785,2021-08-19,Kedah,5950,5282,11232
786,786,786,786,2021-08-19,Kelantan,4201,2360,6561
787,787,787,787,2021-08-19,Melaka,1516,3584,5100
788,788,788,788,2021-08-19,Negeri Sembilan,1877,2156,4033
789,789,789,789,2021-08-19,Pahang,2791,5151,7942
790,790,790,790,2021-08-19,Perak,5137,3116,8253
791,791,791,791,2021-08-19,Perlis,378,61,439
792,792,792,792,2021-08-19,Pulau Pinang,8538,4508,13046
793,793,793,793,2021-08-19,Sabah,7166,8849,16015
794,794,794,794,2021-08-19,Sarawak,3366,16760,20126
795,795,795,795,2021-08-19,Selangor,21565,17105,38670
796,796,796,796,2021-08-19,Terengganu,1780,3933,5713
797,797,797,797,2021-08-19,W.P. Kuala Lumpur,5713,5928,11641
798,798,798,798,2021-08-19,W.P. Labuan,292,97,389
799,799,799,799,2021-08-19,W.P. Putrajaya,148,216,364
800,800,800,800,2021-08-20,Johor,8821,10304,19125
801,801,801,801,2021-08-20,Kedah,5178,5051,10229
802,802,802,802,2021-08-20,Kelantan,2821,2873,5694
803,803,803,803,2021-08-20,Melaka,2163,2226,4389
804,804,804,804,2021-08-20,Negeri Sembilan,2700,2164,4864
805,805,805,805,2021-08-20,Pahang,2008,3968,5976
806,806,806,806,2021-08-20,Perak,5031,3423,8454
807,807,807,807,2021-08-20,Perlis,236,178,414
808,808,808,808,2021-08-20,Pulau Pinang,8463,3949,12412
809,809,809,809,2021-08-20,Sabah,6616,6791,13407
810,810,810,810,2021-08-20,Sarawak,3620,13282,16902
811,811,811,811,2021-08-20,Selangor,22209,16168,38377
812,812,812,812,2021-08-20,Terengganu,1163,3367,4530
813,813,813,813,2021-08-20,W.P. Kuala Lumpur,5029,7239,12268
814,814,814,814,2021-08-20,W.P. Labuan,350,111,461
815,815,815,815,2021-08-20,W.P. Putrajaya,185,176,361
816,816,816,816,2021-08-21,Johor,9212,11626,20838
817,817,817,817,2021-08-21,Kedah,4572,4463,9035
818,818,818,818,2021-08-21,Kelantan,3703,2053,5756
819,819,819,819,2021-08-21,Melaka,1195,3267,4462
820,820,820,820,2021-08-21,Negeri Sembilan,1456,2215,3671
821,821,821,821,2021-08-21,Pahang,2414,3821,6235
822,822,822,822,2021-08-21,Perak,4600,3664,8264
823,823,823,823,2021-08-21,Perlis,143,150,293
824,824,824,824,2021-08-21,Pulau Pinang,7785,4726,12511
825,825,825,825,2021-08-21,Sabah,5090,7362,12452
826,826,826,826,2021-08-21,Sarawak,2772,9890,12662
827,827,827,827,2021-08-21,Selangor,18606,13065,31671
828,828,828,828,2021-08-21,Terengganu,2641,2925,5566
829,829,829,829,2021-08-21,W.P. Kuala Lumpur,3828,5575,9403
830,830,830,830,2021-08-21,W.P. Labuan,375,71,446
831,831,831,831,2021-08-21,W.P. Putrajaya,70,167,237
832,832,832,832,2021-08-22,Johor,10544,9101,19645
833,833,833,833,2021-08-22,Kedah,4891,3576,8467
834,834,834,834,2021-08-22,Kelantan,4444,2175,6619
835,835,835,835,2021-08-22,Melaka,1210,2246,3456
836,836,836,836,2021-08-22,Negeri Sembilan,880,1204,2084
837,837,837,837,2021-08-22,Pahang,1453,4403,5856
838,838,838,838,2021-08-22,Perak,3368,2933,6301
839,839,839,839,2021-08-22,Perlis,192,205,397
840,840,840,840,2021-08-22,Pulau Pinang,6563,2346,8909
841,841,841,841,2021-08-22,Sabah,4723,6595,11318
842,842,842,842,2021-08-22,Sarawak,3392,12190,15582
843,843,843,843,2021-08-22,Selangor,13281,11060,24341
844,844,844,844,2021-08-22,Terengganu,2844,3345,6189
845,845,845,845,2021-08-22,W.P. Kuala Lumpur,2510,3534,6044
846,846,846,846,2021-08-22,W.P. Labuan,381,133,514
847,847,847,847,2021-08-22,W.P. Putrajaya,76,103,179
848,848,848,848,2021-08-23,Johor,13182,7466,20648
849,849,849,849,2021-08-23,Kedah,5824,3810,9634
850,850,850,850,2021-08-23,Kelantan,4183,3412,7595
851,851,851,851,2021-08-23,Melaka,2041,1545,3586
852,852,852,852,2021-08-23,Negeri Sembilan,3195,1150,4345
853,853,853,853,2021-08-23,Pahang,2757,4711,7468
854,854,854,854,2021-08-23,Perak,5720,2325,8045
855,855,855,855,2021-08-23,Perlis,207,94,301
856,856,856,856,2021-08-23,Pulau Pinang,8407,2141,10548
857,857,857,857,2021-08-23,Sabah,7738,6080,13818
858,858,858,858,2021-08-23,Sarawak,3650,9470,13120
859,859,859,859,2021-08-23,Selangor,28344,11308,39652
860,860,860,860,2021-08-23,Terengganu,2156,2106,4262
861,861,861,861,2021-08-23,W.P. Kuala Lumpur,6198,4823,11021
862,862,862,862,2021-08-23,W.P. Labuan,320,72,392
863,863,863,863,2021-08-23,W.P. Putrajaya,264,156,420
864,864,864,864,2021-08-24,Johor,11657,12666,24323
865,865,865,865,2021-08-24,Kedah,5444,4440,9884
866,866,866,866,2021-08-24,Kelantan,4334,2837,7171
867,867,867,867,2021-08-24,Melaka,1265,2137,3402
868,868,868,868,2021-08-24,Negeri Sembilan,2636,3279,5915
869,869,869,869,2021-08-24,Pahang,2757,6592,9349
870,870,870,870,2021-08-24,Perak,5172,4253,9425
871,871,871,871,2021-08-24,Perlis,164,174,338
872,872,872,872,2021-08-24,Pulau Pinang,10775,4777,15552
873,873,873,873,2021-08-24,Sabah,7350,5072,12422
874,874,874,874,2021-08-24,Sarawak,2721,11303,14024
875,875,875,875,2021-08-24,Selangor,28652,16141,44793
876,876,876,876,2021-08-24,Terengganu,1814,3890,5704
877,877,877,877,2021-08-24,W.P. Kuala Lumpur,6513,7813,14326
878,878,878,878,2021-08-24,W.P. Labuan,197,298,495
879,879,879,879,2021-08-24,W.P. Putrajaya,177,222,399
880,880,880,880,2021-08-25,Johor,12850,12068,24918
881,881,881,881,2021-08-25,Kedah,5306,3728,9034
882,882,882,882,2021-08-25,Kelantan,4276,2830,7106
883,883,883,883,2021-08-25,Melaka,1953,1699,3652
884,884,884,884,2021-08-25,Negeri Sembilan,4338,1895,6233
885,885,885,885,2021-08-25,Pahang,2755,4466,7221
886,886,886,886,2021-08-25,Perak,6447,2973,9420
887,887,887,887,2021-08-25,Perlis,169,187,356
888,888,888,888,2021-08-25,Pulau Pinang,9877,4778,14655
889,889,889,889,2021-08-25,Sabah,7252,5728,12980
890,890,890,890,2021-08-25,Sarawak,4009,10941,14950
891,891,891,891,2021-08-25,Selangor,23821,16204,40025
892,892,892,892,2021-08-25,Terengganu,1661,3155,4816
893,893,893,893,2021-08-25,W.P. Kuala Lumpur,4775,7070,11845
894,894,894,894,2021-08-25,W.P. Labuan,481,258,739
895,895,895,895,2021-08-25,W.P. Putrajaya,197,166,363
896,896,896,896,2021-08-26,Johor,12168,10552,22720
897,897,897,897,2021-08-26,Kedah,4261,4515,8776
898,898,898,898,2021-08-26,Kelantan,3359,2525,5884
899,899,899,899,2021-08-26,Melaka,1916,1706,3622
900,900,900,900,2021-08-26,Negeri Sembilan,2467,1608,4075
901,901,901,901,2021-08-26,Pahang,2745,5090,7835
902,902,902,902,2021-08-26,Perak,4301,4388,8689
903,903,903,903,2021-08-26,Perlis,297,132,429
904,904,904,904,2021-08-26,Pulau Pinang,10234,3717,13951
905,905,905,905,2021-08-26,Sabah,7641,4996,12637
906,906,906,906,2021-08-26,Sarawak,3525,11209,14734
907,907,907,907,2021-08-26,Selangor,21864,12177,34041
908,908,908,908,2021-08-26,Terengganu,2122,3017,5139
909,909,909,909,2021-08-26,W.P. Kuala Lumpur,4966,6606,11572
910,910,910,910,2021-08-26,W.P. Labuan,293,233,526
911,911,911,911,2021-08-26,W.P. Putrajaya,185,264,449
912,912,912,912,2021-08-27,Johor,10439,10684,21123
913,913,913,913,2021-08-27,Kedah,4596,4171,8767
914,914,914,914,2021-08-27,Kelantan,2125,2858,4983
915,915,915,915,2021-08-27,Melaka,1864,2974,4838
916,916,916,916,2021-08-27,Negeri Sembilan,2996,1544,4540
917,917,917,917,2021-08-27,Pahang,2921,5166,8087
918,918,918,918,2021-08-27,Perak,5030,3410,8440
919,919,919,919,2021-08-27,Perlis,175,194,369
920,920,920,920,2021-08-27,Pulau Pinang,10226,4096,14322
921,921,921,921,2021-08-27,Sabah,6964,5736,12700
922,922,922,922,2021-08-27,Sarawak,4323,12024,16347
923,923,923,923,2021-08-27,Selangor,21003,12672,33675
924,924,924,924,2021-08-27,Terengganu,1291,4148,5439
925,925,925,925,2021-08-27,W.P. Kuala Lumpur,5129,4935,10064
926,926,926,926,2021-08-27,W.P. Labuan,340,105,445
927,927,927,927,2021-08-27,W.P. Putrajaya,184,259,443
928,928,928,928,2021-08-28,Johor,10089,9866,19955
929,929,929,929,2021-08-28,Kedah,3840,3880,7720
930,930,930,930,2021-08-28,Kelantan,3000,2442,5442
931,931,931,931,2021-08-28,Melaka,1320,2006,3326
932,932,932,932,2021-08-28,Negeri Sembilan,2110,1608,3718
933,933,933,933,2021-08-28,Pahang,2216,4053,6269
934,934,934,934,2021-08-28,Perak,3356,3372,6728
935,935,935,935,2021-08-28,Perlis,107,158,265
936,936,936,936,2021-08-28,Pulau Pinang,7664,5057,12721
937,937,937,937,2021-08-28,Sabah,5640,6201,11841
938,938,938,938,2021-08-28,Sarawak,4636,12368,17004
939,939,939,939,2021-08-28,Selangor,13930,11236,25166
940,940,940,940,2021-08-28,Terengganu,2324,3210,5534
941,941,941,941,2021-08-28,W.P. Kuala Lumpur,3034,5265,8299
942,942,942,942,2021-08-28,W.P. Labuan,389,128,517
943,943,943,943,2021-08-28,W.P. Putrajaya,53,246,299
944,944,944,944,2021-08-29,Johor,11579,8369,19948
945,945,945,945,2021-08-29,Kedah,4510,4392,8902
946,946,946,946,2021-08-29,Kelantan,2954,2221,5175
947,947,947,947,2021-08-29,Melaka,1013,1043,2056
948,948,948,948,2021-08-29,Negeri Sembilan,1708,829,2537
949,949,949,949,2021-08-29,Pahang,1664,4115,5779
950,950,950,950,2021-08-29,Perak,2892,2254,5146
951,951,951,951,2021-08-29,Perlis,207,151,358
952,952,952,952,2021-08-29,Pulau Pinang,4042,1659,5701
953,953,953,953,2021-08-29,Sabah,4076,4386,8462
954,954,954,954,2021-08-29,Sarawak,3103,10662,13765
955,955,955,955,2021-08-29,Selangor,10402,7923,18325
956,956,956,956,2021-08-29,Terengganu,3340,3228,6568
957,957,957,957,2021-08-29,W.P. Kuala Lumpur,2758,2618,5376
958,958,958,958,2021-08-29,W.P. Labuan,144,199,343
959,959,959,959,2021-08-29,W.P. Putrajaya,70,181,251
960,960,960,960,2021-08-30,Johor,12963,8582,21545
961,961,961,961,2021-08-30,Kedah,5009,4073,9082
962,962,962,962,2021-08-30,Kelantan,2931,3276,6207
963,963,963,963,2021-08-30,Melaka,2578,1557,4135
964,964,964,964,2021-08-30,Negeri Sembilan,4170,1282,5452
965,965,965,965,2021-08-30,Pahang,3181,4790,7971
966,966,966,966,2021-08-30,Perak,4711,2026,6737
967,967,967,967,2021-08-30,Perlis,196,89,285
968,968,968,968,2021-08-30,Pulau Pinang,8502,2800,11302
969,969,969,969,2021-08-30,Sabah,8133,3218,11351
970,970,970,970,2021-08-30,Sarawak,7149,10830,17979
971,971,971,971,2021-08-30,Selangor,24784,11085,35869
972,972,972,972,2021-08-30,Terengganu,2724,2705,5429
973,973,973,973,2021-08-30,W.P. Kuala Lumpur,5874,6225,12099
974,974,974,974,2021-08-30,W.P. Labuan,338,120,458
975,975,975,975,2021-08-30,W.P. Putrajaya,271,235,506
976,976,976,976,2021-08-31,Johor,8119,10228,18347
977,977,977,977,2021-08-31,Kedah,2535,3642,6177
978,978,978,978,2021-08-31,Kelantan,1832,3012,4844
979,979,979,979,2021-08-31,Melaka,2707,1179,3886
980,980,980,980,2021-08-31,Negeri Sembilan,1608,1555,3163
981,981,981,981,2021-08-31,Pahang,1267,3105,4372
982,982,982,982,2021-08-31,Perak,2287,2657,4944
983,983,983,983,2021-08-31,Perlis,148,248,396
984,984,984,984,2021-08-31,Pulau Pinang,6086,3990,10076
985,985,985,985,2021-08-31,Sabah,4157,4335,8492
986,986,986,986,2021-08-31,Sarawak,4493,11107,15600
987,987,987,987,2021-08-31,Selangor,16278,14598,30876
988,988,988,988,2021-08-31,Terengganu,1345,3094,4439
989,989,989,989,2021-08-31,W.P. Kuala Lumpur,2461,3960,6421
990,990,990,990,2021-08-31,W.P. Labuan,170,259,429
991,991,991,991,2021-08-31,W.P. Putrajaya,80,156,236
992,992,992,992,2021-09-01,Johor,13669,11222,24891
993,993,993,993,2021-09-01,Kedah,5042,5018,10060
994,994,994,994,2021-09-01,Kelantan,2354,1938,4292
995,995,995,995,2021-09-01,Melaka,2583,2051,4634
996,996,996,996,2021-09-01,Negeri Sembilan,3167,1397,4564
997,997,997,997,2021-09-01,Pahang,3142,4422,7564
998,998,998,998,2021-09-01,Perak,5035,2451,7486
999,999,999,999,2021-09-01,Perlis,187,143,330
1000,1000,1000,1000,2021-09-01,Pulau Pinang,9028,2596,11624
1001,1001,1001,1001,2021-09-01,Sabah,7068,3575,10643
1002,1002,1002,1002,2021-09-01,Sarawak,7236,12457,19693
1003,1003,1003,1003,2021-09-01,Selangor,27504,11435,38939
1004,1004,1004,1004,2021-09-01,Terengganu,1992,4931,6923
1005,1005,1005,1005,2021-09-01,W.P. Kuala Lumpur,7549,4951,12500
1006,1006,1006,1006,2021-09-01,W.P. Labuan,360,212,572
1007,1007,1007,1007,2021-09-01,W.P. Putrajaya,267,244,511
1008,1008,1008,1008,2021-09-02,Johor,14621,11264,25885
1009,1009,1009,1009,2021-09-02,Kedah,4880,3353,8233
1010,1010,1010,1010,2021-09-02,Kelantan,2420,2753,5173
1011,1011,1011,1011,2021-09-02,Melaka,3468,1531,4999
1012,1012,1012,1012,2021-09-02,Negeri Sembilan,2952,2140,5092
1013,1013,1013,1013,2021-09-02,Pahang,2495,3949,6444
1014,1014,1014,1014,2021-09-02,Perak,5133,3035,8168
1015,1015,1015,1015,2021-09-02,Perlis,221,163,384
1016,1016,1016,1016,2021-09-02,Pulau Pinang,9078,4257,13335
1017,1017,1017,1017,2021-09-02,Sabah,6986,3858,10844
1018,1018,1018,1018,2021-09-02,Sarawak,8606,12328,20934
1019,1019,1019,1019,2021-09-02,Selangor,20690,13185,33875
1020,1020,1020,1020,2021-09-02,Terengganu,2414,3248,5662
1021,1021,1021,1021,2021-09-02,W.P. Kuala Lumpur,5646,4649,10295
1022,1022,1022,1022,2021-09-02,W.P. Labuan,439,128,567
1023,1023,1023,1023,2021-09-02,W.P. Putrajaya,183,194,377
1024,1024,1024,1024,2021-09-03,Johor,9488,10373,19861
1025,1025,1025,1025,2021-09-03,Kedah,3879,3522,7401
1026,1026,1026,1026,2021-09-03,Kelantan,1687,3043,4730
1027,1027,1027,1027,2021-09-03,Melaka,1845,1420,3265
1028,1028,1028,1028,2021-09-03,Negeri Sembilan,2093,1212,3305
1029,1029,1029,1029,2021-09-03,Pahang,3462,3720,7182
1030,1030,1030,1030,2021-09-03,Perak,4518,2613,7131
1031,1031,1031,1031,2021-09-03,Perlis,208,171,379
1032,1032,1032,1032,2021-09-03,Pulau Pinang,9049,4005,13054
1033,1033,1033,1033,2021-09-03,Sabah,5689,2999,8688
1034,1034,1034,1034,2021-09-03,Sarawak,8189,16581,24770
1035,1035,1035,1035,2021-09-03,Selangor,20807,10703,31510
1036,1036,1036,1036,2021-09-03,Terengganu,1217,3878,5095
1037,1037,1037,1037,2021-09-03,W.P. Kuala Lumpur,5233,5099,10332
1038,1038,1038,1038,2021-09-03,W.P. Labuan,222,212,434
1039,1039,1039,1039,2021-09-03,W.P. Putrajaya,159,214,373
1040,1040,1040,1040,2021-09-04,Johor,9687,9927,19614
1041,1041,1041,1041,2021-09-04,Kedah,3489,3842,7331
1042,1042,1042,1042,2021-09-04,Kelantan,2102,1883,3985
1043,1043,1043,1043,2021-09-04,Melaka,4766,1638,6404
1044,1044,1044,1044,2021-09-04,Negeri Sembilan,1071,1471,2542
1045,1045,1045,1045,2021-09-04,Pahang,2170,3360,5530
1046,1046,1046,1046,2021-09-04,Perak,4414,2662,7076
1047,1047,1047,1047,2021-09-04,Perlis,182,188,370
1048,1048,1048,1048,2021-09-04,Pulau Pinang,6476,4228,10704
1049,1049,1049,1049,2021-09-04,Sabah,4009,4936,8945
1050,1050,1050,1050,2021-09-04,Sarawak,6701,15066,21767
1051,1051,1051,1051,2021-09-04,Selangor,13035,10731,23766
1052,1052,1052,1052,2021-09-04,Terengganu,2548,3543,6091
1053,1053,1053,1053,2021-09-04,W.P. Kuala Lumpur,3022,4970,7992
1054,1054,1054,1054,2021-09-04,W.P. Labuan,347,272,619
1055,1055,1055,1055,2021-09-04,W.P. Putrajaya,66,246,312
1056,1056,1056,1056,2021-09-05,Johor,10679,7920,18599
1057,1057,1057,1057,2021-09-05,Kedah,4154,3220,7374
1058,1058,1058,1058,2021-09-05,Kelantan,2336,2283,4619
1059,1059,1059,1059,2021-09-05,Melaka,1498,1642,3140
1060,1060,1060,1060,2021-09-05,Negeri Sembilan,1026,1042,2068
1061,1061,1061,1061,2021-09-05,Pahang,2287,3398,5685
1062,1062,1062,1062,2021-09-05,Perak,3482,2016,5498
1063,1063,1063,1063,2021-09-05,Perlis,190,119,309
1064,1064,1064,1064,2021-09-05,Pulau Pinang,3514,1982,5496
1065,1065,1065,1065,2021-09-05,Sabah,4082,2770,6852
1066,1066,1066,1066,2021-09-05,Sarawak,5877,14786,20663
1067,1067,1067,1067,2021-09-05,Selangor,11632,7159,18791
1068,1068,1068,1068,2021-09-05,Terengganu,2776,2670,5446
1069,1069,1069,1069,2021-09-05,W.P. Kuala Lumpur,2151,2954,5105
1070,1070,1070,1070,2021-09-05,W.P. Labuan,252,281,533
1071,1071,1071,1071,2021-09-05,W.P. Putrajaya,77,242,319
1072,1072,1072,1072,2021-09-06,Johor,13736,9266,23002
1073,1073,1073,1073,2021-09-06,Kedah,4943,3141,8084
1074,1074,1074,1074,2021-09-06,Kelantan,1983,3068,5051
1075,1075,1075,1075,2021-09-06,Melaka,2914,1191,4105
1076,1076,1076,1076,2021-09-06,Negeri Sembilan,3774,1141,4915
1077,1077,1077,1077,2021-09-06,Pahang,3950,5142,9092
1078,1078,1078,1078,2021-09-06,Perak,5546,1825,7371
1079,1079,1079,1079,2021-09-06,Perlis,191,80,271
1080,1080,1080,1080,2021-09-06,Pulau Pinang,6919,3050,9969
1081,1081,1081,1081,2021-09-06,Sabah,6815,2321,9136
1082,1082,1082,1082,2021-09-06,Sarawak,8914,16978,25892
1083,1083,1083,1083,2021-09-06,Selangor,27592,9248,36840
1084,1084,1084,1084,2021-09-06,Terengganu,2707,2309,5016
1085,1085,1085,1085,2021-09-06,W.P. Kuala Lumpur,6271,6313,12584
1086,1086,1086,1086,2021-09-06,W.P. Labuan,400,176,576
1087,1087,1087,1087,2021-09-06,W.P. Putrajaya,262,153,415
1088,1088,1088,1088,2021-09-07,Johor,13154,11668,24822
1089,1089,1089,1089,2021-09-07,Kedah,4780,3714,8494
1090,1090,1090,1090,2021-09-07,Kelantan,1909,2670,4579
1091,1091,1091,1091,2021-09-07,Melaka,2271,2049,4320
1092,1092,1092,1092,2021-09-07,Negeri Sembilan,4369,2328,6697
1093,1093,1093,1093,2021-09-07,Pahang,2343,3584,5927
1094,1094,1094,1094,2021-09-07,Perak,5224,2918,8142
1095,1095,1095,1095,2021-09-07,Perlis,274,186,460
1096,1096,1096,1096,2021-09-07,Pulau Pinang,8624,4371,12995
1097,1097,1097,1097,2021-09-07,Sabah,6777,3217,9994
1098,1098,1098,1098,2021-09-07,Sarawak,8820,14253,23073
1099,1099,1099,1099,2021-09-07,Selangor,22944,14261,37205
1100,1100,1100,1100,2021-09-07,Terengganu,2120,4232,6352
1101,1101,1101,1101,2021-09-07,W.P. Kuala Lumpur,5209,5165,10374
1102,1102,1102,1102,2021-09-07,W.P. Labuan,402,278,680
1103,1103,1103,1103,2021-09-07,W.P. Putrajaya,212,226,438
1104,1104,1104,1104,2021-09-08,Johor,12220,10283,22503
1105,1105,1105,1105,2021-09-08,Kedah,5018,3594,8612
1106,1106,1106,1106,2021-09-08,Kelantan,1858,2891,4749
1107,1107,1107,1107,2021-09-08,Melaka,1896,2112,4008
1108,1108,1108,1108,2021-09-08,Negeri Sembilan,2726,1285,4011
1109,1109,1109,1109,2021-09-08,Pahang,2296,5143,7439
1110,1110,1110,1110,2021-09-08,Perak,5302,3092,8394
1111,1111,1111,1111,2021-09-08,Perlis,217,255,472
1112,1112,1112,1112,2021-09-08,Pulau Pinang,8307,3988,12295
1113,1113,1113,1113,2021-09-08,Sabah,6407,3552,9959
1114,1114,1114,1114,2021-09-08,Sarawak,9042,12211,21253
1115,1115,1115,1115,2021-09-08,Selangor,23080,13087,36167
1116,1116,1116,1116,2021-09-08,Terengganu,2222,4072,6294
1117,1117,1117,1117,2021-09-08,W.P. Kuala Lumpur,4330,5135,9465
1118,1118,1118,1118,2021-09-08,W.P. Labuan,482,169,651
1119,1119,1119,1119,2021-09-08,W.P. Putrajaya,293,184,477
1120,1120,1120,1120,2021-09-09,Johor,11204,9469,20673
1121,1121,1121,1121,2021-09-09,Kedah,3965,3193,7158
1122,1122,1122,1122,2021-09-09,Kelantan,1841,3067,4908
1123,1123,1123,1123,2021-09-09,Melaka,2059,1469,3528
1124,1124,1124,1124,2021-09-09,Negeri Sembilan,2343,1717,4060
1125,1125,1125,1125,2021-09-09,Pahang,3315,4622,7937
1126,1126,1126,1126,2021-09-09,Perak,4814,2448,7262
1127,1127,1127,1127,2021-09-09,Perlis,235,191,426
1128,1128,1128,1128,2021-09-09,Pulau Pinang,7790,3229,11019
1129,1129,1129,1129,2021-09-09,Sabah,5746,2771,8517
1130,1130,1130,1130,2021-09-09,Sarawak,8120,16037,24157
1131,1131,1131,1131,2021-09-09,Selangor,18011,9960,27971
1132,1132,1132,1132,2021-09-09,Terengganu,2574,3195,5769
1133,1133,1133,1133,2021-09-09,W.P. Kuala Lumpur,4410,4817,9227
1134,1134,1134,1134,2021-09-09,W.P. Labuan,635,279,914
1135,1135,1135,1135,2021-09-09,W.P. Putrajaya,197,198,395
1136,1136,1136,1136,2021-09-10,Johor,8928,9002,17930
1137,1137,1137,1137,2021-09-10,Kedah,3103,2882,5985
1138,1138,1138,1138,2021-09-10,Kelantan,1199,3220,4419
1139,1139,1139,1139,2021-09-10,Melaka,1471,1716,3187
1140,1140,1140,1140,2021-09-10,Negeri Sembilan,2913,1088,4001
1141,1141,1141,1141,2021-09-10,Pahang,2867,3515,6382
1142,1142,1142,1142,2021-09-10,Perak,5128,2645,7773
1143,1143,1143,1143,2021-09-10,Perlis,264,159,423
1144,1144,1144,1144,2021-09-10,Pulau Pinang,7735,2965,10700
1145,1145,1145,1145,2021-09-10,Sabah,5448,3183,8631
1146,1146,1146,1146,2021-09-10,Sarawak,8109,11940,20049
1147,1147,1147,1147,2021-09-10,Selangor,16400,11528,27928
1148,1148,1148,1148,2021-09-10,Terengganu,1480,4633,6113
1149,1149,1149,1149,2021-09-10,W.P. Kuala Lumpur,4247,3505,7752
1150,1150,1150,1150,2021-09-10,W.P. Labuan,263,221,484
1151,1151,1151,1151,2021-09-10,W.P. Putrajaya,176,288,464
1152,1152,1152,1152,2021-09-11,Johor,9588,9277,18865
1153,1153,1153,1153,2021-09-11,Kedah,3000,2848,5848
1154,1154,1154,1154,2021-09-11,Kelantan,1845,2186,4031
1155,1155,1155,1155,2021-09-11,Melaka,1133,1509,2642
1156,1156,1156,1156,2021-09-11,Negeri Sembilan,1961,1121,3082
1157,1157,1157,1157,2021-09-11,Pahang,2380,3633,6013
1158,1158,1158,1158,2021-09-11,Perak,4546,2366,6912
1159,1159,1159,1159,2021-09-11,Perlis,146,200,346
1160,1160,1160,1160,2021-09-11,Pulau Pinang,5653,4327,9980
1161,1161,1161,1161,2021-09-11,Sabah,3943,3571,7514
1162,1162,1162,1162,2021-09-11,Sarawak,6748,17906,24654
1163,1163,1163,1163,2021-09-11,Selangor,11506,9564,21070
1164,1164,1164,1164,2021-09-11,Terengganu,2852,2848,5700
1165,1165,1165,1165,2021-09-11,W.P. Kuala Lumpur,2649,3906,6555
1166,1166,1166,1166,2021-09-11,W.P. Labuan,473,344,817
1167,1167,1167,1167,2021-09-11,W.P. Putrajaya,70,549,619
1168,1168,1168,1168,2021-09-12,Johor,9237,6691,15928
1169,1169,1169,1169,2021-09-12,Kedah,3186,3051,6237
1170,1170,1170,1170,2021-09-12,Kelantan,1910,2301,4211
1171,1171,1171,1171,2021-09-12,Melaka,3177,1370,4547
1172,1172,1172,1172,2021-09-12,Negeri Sembilan,893,890,1783
1173,1173,1173,1173,2021-09-12,Pahang,1791,4651,6442
1174,1174,1174,1174,2021-09-12,Perak,3063,1617,4680
1175,1175,1175,1175,2021-09-12,Perlis,201,86,287
1176,1176,1176,1176,2021-09-12,Pulau Pinang,3558,1457,5015
1177,1177,1177,1177,2021-09-12,Sabah,3239,2654,5893
1178,1178,1178,1178,2021-09-12,Sarawak,4319,12887,17206
1179,1179,1179,1179,2021-09-12,Selangor,8713,7277,15990
1180,1180,1180,1180,2021-09-12,Terengganu,3227,3152,6379
1181,1181,1181,1181,2021-09-12,W.P. Kuala Lumpur,1836,2554,4390
1182,1182,1182,1182,2021-09-12,W.P. Labuan,268,149,417
1183,1183,1183,1183,2021-09-12,W.P. Putrajaya,78,177,255
